Date,BEDCAP_ICU,VENTCAP_ICU,BEDCAP_OTHER,VENTCAP_OTHER,COVID_NEWICU,COVID_ICU,COVID_NEWOTHER,COVID_OTHER,COVID_VENT,VENTCAP_TOTAL,NONCOVID_ICU,NONCOVID_OTHER,NONCOVID_VENT,COVID_HOSP
2020-04-01,2817,2058,30172,536,0,193,0,327,127,2594,169,6540,106,520
2020-04-02,2856,2089,30219,557,0,225,0,346,155,2646,0,6545,0,571
2020-04-03,2856,2089,30087,557,0,228,0,368,167,2646,0,6544,0,596
2020-04-04,2856,2089,30452,557,0,233,0,435,169,2646,1,6541,0,668
2020-04-05,2856,2089,30792,557,0,254,0,443,177,2646,0,6514,0,697
2020-04-06,4152,2089,46640,557,0,433,0,838,322,2646,0,6514,0,1271
2020-04-07,4152,2089,46621,557,0,461,0,893,348,2646,0,6538,0,1354
2020-04-08,4152,2741,47361,615,0,493,0,951,380,3356,164,6613,90,1444
2020-04-09,5063,3581,57260,615,0,544,51,1110,438,4196,1426,23405,417,1654
2020-04-10,5063,3581,57028,615,40,498,90,1218,380,4196,1415,23372,404,1716
2020-04-11,5103,3581,57664,615,12,509,125,1266,367,4196,1033,17551,379,1775
2020-04-12,5103,3581,57536,615,13,519,138,1313,382,4196,1030,17673,380,1832
2020-04-13,5103,3581,57533,615,11,500,164,1411,374,4196,1510,24941,396,1911
2020-04-14,5104,3582,57738,617,15,529,181,1426,377,4199,1510,25359,395,1955
2020-04-15,5372,3879,59426,575,11,522,159,1517,382,4454,1681,26036,508,2039
2020-04-16,6556,3883,59954,575,12,527,157,1547,373,4458,1448,27944,454,2074
2020-04-17,6556,3883,59530,575,15,525,213,1614,365,4458,1388,25589,448,2139
2020-04-18,6552,3891,59337,575,2,515,136,1635,363,4466,1368,25819,386,2150
2020-04-19,6552,3876,59367,575,22,534,195,1737,366,4451,1231,21453,424,2271
2020-04-20,6552,3856,59924,621,15,530,170,1813,364,4477,1466,26873,457,2343
2020-04-21,6552,3856,59952,621,13,524,202,1882,362,4477,1587,28912,480,2406
2020-04-22,6570,3856,59638,582,18,516,309,2044,352,4438,1667,26864,527,2560
2020-04-23,6570,3856,59543,582,20,541,214,2091,379,4438,1612,28750,496,2632
2020-04-24,6567,3855,59611,582,13,525,214,2164,380,4437,1524,26726,446,2689
2020-04-25,6567,3855,59707,582,8,525,150,2183,374,4437,1525,27013,428,2708
2020-04-26,6567,3855,59205,582,14,519,166,2226,372,4437,1325,22060,433,2745
2020-04-27,6567,3855,59219,582,12,520,238,2335,374,4437,1579,27377,478,2855
2020-04-28,6566,3854,59710,582,9,525,226,2374,367,4436,1683,29626,507,2899
2020-04-29,6651,3939,62276,590,12,510,247,2444,355,4529,1750,27989,570,2954
2020-04-30,6651,3939,62278,590,11,502,203,2441,350,4529,1620,29814,491,2943
2020-05-01,6651,3939,61728,590,18,497,204,2481,326,4529,1618,27470,467,2978
2020-05-02,6651,3939,61508,590,9,498,182,2493,345,4529,1633,27408,439,2991
2020-05-03,6651,3939,62140,590,12,491,135,2573,340,4529,1323,21563,424,3064
2020-05-04,6651,3939,62377,590,19,490,211,2611,332,4529,1758,30477,477,3101
2020-05-05,6651,3939,62466,590,12,482,191,2638,339,4529,1689,28723,472,3120
2020-05-06,6648,3936,62564,606,15,489,181,2614,321,4542,1814,29296,547,3103
2020-05-07,6651,3939,62693,659,4,466,187,2621,327,4598,1711,30897,444,3087
2020-05-08,6649,3937,62145,661,11,452,177,2587,308,4598,1618,28617,421,3039
2020-05-09,6649,3937,62506,661,13,440,130,2649,285,4598,1646,28640,391,3089
2020-05-10,6649,3937,62567,661,4,429,112,2660,289,4598,1313,22349,417,3089
2020-05-11,6649,3937,62734,661,5,417,148,2667,284,4598,1966,31322,548,3084
2020-05-12,6649,3937,61953,681,11,420,177,2701,288,4618,1722,29157,462,3121
2020-05-13,6651,3939,62758,679,10,408,184,2628,290,4618,1757,29784,448,3036
2020-05-14,6654,3939,62576,683,9,401,148,2663,280,4622,1968,29931,546,3064
2020-05-15,6654,3939,62386,683,37,395,295,2616,269,4622,1756,29192,445,3011
2020-05-16,6654,3939,62502,683,10,381,146,2621,260,4622,1699,28881,424,3002
2020-05-17,5947,3939,52111,683,7,368,118,2582,248,4622,1357,22394,421,2950
2020-05-18,6654,3939,62232,683,13,374,111,2654,250,4622,1711,29374,436,3028
2020-05-19,6654,3939,62628,683,15,371,130,2405,246,4622,1856,32022,504,2776
2020-05-20,6654,3939,62565,683,5,355,115,2354,235,4622,1995,30564,574,2709
2020-05-21,6642,3939,62541,683,11,346,137,2288,235,4622,1872,32615,466,2634
2020-05-22,6642,3939,61998,683,4,336,128,2231,230,4622,1786,29968,468,2567
2020-05-23,6642,3939,61776,683,7,340,72,2185,215,4622,1823,29662,423,2525
2020-05-24,5947,3939,51545,683,14,340,74,2143,223,4622,1453,23190,403,2483
2020-05-25,6583,3880,62721,758,12,344,120,2180,224,4638,2112,33082,598,2524
2020-05-26,6583,3880,62656,758,9,350,98,2123,229,4638,1844,31360,488,2473
2020-05-27,6583,3880,62757,758,1,332,120,2089,207,4638,1905,31693,496,2421
2020-05-28,6583,3880,62748,758,8,319,171,2004,206,4638,1987,33547,502,2323
2020-05-29,6583,3880,62359,758,3,304,91,1949,187,4638,1868,30938,470,2253
2020-05-30,6583,3880,62778,758,7,304,75,1935,201,4638,1797,31195,440,2239
2020-05-31,6583,3880,62785,758,1,302,69,1942,197,4638,1437,24242,419,2244
2020-06-01,6583,3880,62647,758,7,300,83,1917,186,4638,2163,33635,589,2217
2020-06-02,6583,3880,62792,758,5,301,79,1870,193,4638,1925,32003,497,2171
2020-06-03,6583,3880,62701,758,8,284,79,1804,182,4638,1903,31880,477,2088
2020-06-04,6583,3880,62678,758,2,265,54,1674,179,4638,1913,31993,487,1939
2020-06-05,6583,3880,62801,758,2,261,71,1584,179,4638,1907,31490,501,1845
2020-06-06,6583,3880,62787,758,3,262,41,1541,179,4638,1498,23898,442,1803
2020-06-07,6583,3880,62736,758,1,252,52,1555,163,4638,1478,24199,432,1807
2020-06-08,6433,3730,62891,908,4,249,52,1522,165,4638,2192,34006,595,1771
2020-06-09,6433,3730,61710,908,5,252,39,1420,160,4638,1951,31521,523,1672
2020-06-10,6433,3730,62884,908,5,249,57,1363,156,4638,1971,32527,517,1612
2020-06-11,6433,3730,62879,908,3,237,45,1313,149,4638,2001,34305,528,1550
2020-06-12,6433,3730,62636,908,4,227,86,1220,129,4638,1902,31676,459,1447
2020-06-13,6433,3730,62869,908,0,203,32,1193,135,4638,1867,31636,446,1396
2020-06-14,5738,3730,52344,908,3,199,30,1173,114,4638,1478,24498,462,1372
2020-06-15,6429,3730,63091,908,1,193,23,1120,119,4638,2200,34512,598,1313
2020-06-16,6429,3730,63103,908,1,182,39,1046,111,4638,1978,32971,533,1228
2020-06-17,6429,3730,62662,908,0,166,32,983,104,4638,2027,32818,531,1149
2020-06-18,6429,3730,62357,908,1,159,80,910,107,4638,2095,34406,549,1069
2020-06-19,6429,3730,62989,908,1,158,32,823,107,4638,1985,32588,533,981
2020-06-20,6429,3730,62993,908,2,166,31,794,101,4638,1580,24986,466,960
2020-06-21,6429,3730,62905,908,0,151,29,806,100,4638,1554,25193,458,957
2020-06-22,6429,3730,65699,908,1,145,89,796,94,4638,2341,37033,667,941
2020-06-23,6429,3730,65680,908,3,142,32,781,85,4638,2125,35395,592,923
2020-06-24,6429,3730,65646,908,1,135,28,750,85,4638,2078,35474,597,885
2020-06-25,6429,3730,65616,908,5,127,38,744,79,4638,2160,37467,595,871
2020-06-26,6429,3730,65733,908,1,114,38,714,68,4638,2043,34864,536,828
2020-06-27,6429,3730,65095,908,2,110,19,715,68,4638,1565,25015,453,825
2020-06-28,6429,3730,65334,908,3,107,27,698,65,4638,1604,25547,473,805
2020-06-29,6429,3730,65286,908,3,95,25,688,61,4638,2411,37566,647,783
2020-06-30,6429,3730,65562,908,2,91,30,622,52,4638,2099,35779,572,713
2020-07-01,6429,3730,65450,908,3,87,28,617,45,4638,1567,25752,441,704
2020-07-02,6429,3730,65559,908,3,87,20,591,48,4638,2146,37649,542,678
2020-07-03,6429,3730,65406,908,0,81,15,576,48,4638,2036,35239,530,657
2020-07-04,6429,3730,65488,908,0,79,20,566,46,4638,1924,33299,420,645
2020-07-05,6429,3730,65521,908,0,73,21,572,43,4638,1624,25785,428,645
2020-07-06,6488,3789,65049,849,0,71,15,530,41,4638,2461,38062,627,601
2020-07-07,6488,3789,65456,849,3,73,23,508,43,4638,2225,36596,555,581
2020-07-08,6488,3789,65441,849,1,68,25,476,36,4638,2180,37844,603,544
2020-07-09,6488,3789,65398,849,1,72,54,492,36,4638,2263,38611,595,564
2020-07-10,6488,3789,65370,849,0,67,22,469,29,4638,2130,35989,561,536
2020-07-11,6488,3789,65356,849,1,66,16,478,30,4638,1989,33828,435,544
2020-07-12,6488,3789,65394,849,1,68,25,483,30,4638,1649,26296,419,551
2020-07-13,6488,3789,65445,849,2,71,15,452,34,4638,2416,38729,528,523
2020-07-14,6488,3789,65453,849,1,65,25,446,35,4638,2188,36927,546,511
2020-07-15,6488,3789,65037,849,2,62,20,445,33,4638,2164,36657,574,507
2020-07-16,6488,3789,65056,849,0,67,29,429,32,4638,2257,38703,563,496
2020-07-17,6488,3789,64278,849,1,65,26,427,32,4638,2145,35503,524,492
2020-07-18,6488,3789,65187,849,2,67,20,441,34,4638,1635,26097,451,508
2020-07-19,6488,3789,65438,849,1,71,34,442,35,4638,1619,26408,410,513
2020-07-20,6488,3789,65378,849,2,72,20,455,42,4638,2403,38863,653,527
2020-07-21,6488,3789,65380,849,3,74,25,472,38,4638,2128,36944,549,546
2020-07-22,6488,3789,65397,849,0,73,40,451,41,4638,2156,36956,524,524
2020-07-23,6488,3789,65142,849,3,67,13,398,42,4638,2221,39041,551,465
2020-07-24,6488,3789,65307,849,0,65,13,377,42,4638,2145,36289,554,442
2020-07-25,6488,3789,65288,849,0,63,30,363,43,4638,1606,26219,405,426
2020-07-26,6488,3789,65216,849,0,62,40,376,40,4638,1609,26614,408,438
2020-07-27,6488,3789,65405,849,1,61,26,362,37,4638,2495,38810,652,423
2020-07-28,6488,3789,65345,849,1,62,21,341,37,4638,2191,37054,518,403
2020-07-29,6488,3789,65345,849,5,71,59,344,37,4638,2216,37030,530,415
2020-07-30,6488,3789,66676,849,2,69,28,313,40,4638,2272,38871,548,382
2020-07-31,6488,3789,65332,849,1,71,14,296,37,4638,2055,34347,455,367
2020-08-01,6488,3789,65185,849,0,74,11,290,39,4638,1606,26032,443,364
2020-08-02,6488,3789,65161,849,2,76,18,287,38,4638,1595,26167,433,363
2020-08-03,6488,3789,64898,849,2,84,15,263,40,4638,1725,28486,451,347
2020-08-04,6488,3789,65017,849,2,84,20,263,44,4638,2383,36736,632,347
2020-08-05,6488,3789,65411,849,1,85,14,245,42,4638,2169,37232,533,330
2020-08-06,6488,3789,65448,849,1,81,28,218,38,4638,2251,39287,545,299
2020-08-07,6488,3789,65326,849,3,77,17,227,36,4638,2157,36584,527,304
2020-08-08,6488,3789,65215,849,2,75,8,224,38,4638,1621,26327,436,299
2020-08-09,6488,3789,65229,849,0,70,10,234,41,4638,1636,26603,411,304
2020-08-10,6512,3813,65456,825,2,67,9,214,35,4638,2510,39229,684,281
2020-08-11,6512,3813,65374,825,3,66,9,204,32,4638,2199,37591,542,270
2020-08-12,6512,3813,65497,825,2,69,24,198,32,4638,2175,37797,542,267
2020-08-13,6512,3813,65320,825,2,67,21,232,30,4638,2213,39086,581,299
2020-08-14,6512,3813,65386,825,0,66,15,201,31,4638,2149,36839,550,267
2020-08-15,6512,3813,65353,825,1,66,16,197,30,4638,1642,26572,450,263
2020-08-16,6512,3813,65004,825,1,61,5,202,30,4638,1663,26560,462,263
2020-08-17,6512,3813,65521,825,4,63,13,196,29,4638,2509,39566,679,259
2020-08-18,6512,3813,65099,827,0,63,10,193,24,4640,2231,37513,567,256
2020-08-19,6512,3813,65260,827,0,62,41,193,23,4640,2217,37691,585,255
2020-08-20,6512,3813,65085,827,0,56,9,190,22,4640,2310,39521,564,246
2020-08-21,6512,3813,65404,827,0,50,10,190,20,4640,2193,37182,520,240
2020-08-22,6512,3813,65043,827,0,45,7,185,20,4640,1642,26444,399,230
2020-08-23,6512,3813,65487,827,0,43,12,183,22,4640,1671,27149,419,226
2020-08-24,6512,3813,65425,857,0,42,17,196,22,4670,2542,39581,692,238
2020-08-25,6512,3813,65459,857,0,45,13,197,21,4670,2254,37980,555,242
2020-08-26,6512,3813,64940,857,3,50,19,211,22,4670,2252,37567,550,261
2020-08-27,6512,3813,65059,857,1,52,14,200,24,4670,1897,31558,581,252
2020-08-28,6512,3813,65320,857,1,52,10,197,16,4670,1781,29049,455,249
2020-08-29,6512,3813,65155,857,1,54,12,190,23,4670,1711,26713,463,244
2020-08-30,6512,3813,65401,857,2,58,17,203,21,4670,1680,27060,463,261
2020-08-31,6512,3813,65406,827,3,60,10,208,17,4640,2468,39562,672,268
2020-09-01,6512,3813,65525,827,1,56,18,213,23,4640,2202,37811,549,269
2020-09-02,6512,3813,65508,827,1,58,9,206,28,4640,2182,37705,556,264
2020-09-03,6512,3813,65418,827,1,55,17,208,25,4640,2270,39599,589,263
2020-09-04,6512,3813,65483,827,1,58,11,190,27,4640,2174,36943,564,248
2020-09-05,5817,3813,54784,827,2,49,18,177,21,4640,1680,26502,443,226
2020-09-06,5817,3813,54966,827,1,50,10,177,21,4640,1679,26623,458,227
2020-09-07,5817,3813,55006,827,1,45,10,181,21,4640,1797,29230,491,226
2020-09-08,6512,3813,65525,827,1,52,23,210,25,4640,2434,37625,713,262
2020-09-09,6512,3813,65536,827,0,52,15,217,26,4640,2277,37930,595,269
2020-09-10,6512,3813,65495,827,0,53,21,217,27,4640,2381,40056,620,270
2020-09-11,6512,3813,65395,827,5,48,20,229,27,4640,2254,37330,592,277
2020-09-12,6512,3813,65388,827,2,54,16,229,29,4640,1707,27106,470,283
2020-09-13,6512,3813,65067,827,0,55,14,225,28,4640,1716,26881,452,280
2020-09-14,6512,3813,65152,826,6,68,23,231,31,4639,2610,39918,692,299
2020-09-15,6512,3813,65523,826,3,74,18,233,34,4639,2292,38414,570,307
2020-09-16,6484,3794,65701,845,5,84,25,236,33,4639,2288,38757,557,320
2020-09-17,6484,3794,65711,845,0,80,26,248,34,4639,2367,40917,607,328
2020-09-18,6484,3794,65643,845,2,82,16,249,35,4639,2253,37988,602,331
2020-09-19,6484,3794,65570,845,2,87,19,254,38,4639,1730,27594,496,341
2020-09-20,6484,3794,65609,845,3,88,36,281,43,4639,1705,27774,498,369
2020-09-21,6484,3794,65609,845,5,86,41,313,46,4639,2577,40329,705,399
2020-09-22,6484,3794,65649,845,2,93,24,327,42,4639,2299,38566,553,420
2020-09-23,6484,3794,65651,845,4,94,28,340,43,4639,2321,38573,604,434
2020-09-24,6484,3794,65492,866,6,100,38,362,45,4660,2378,40933,620,462
2020-09-25,6484,3794,65614,866,10,115,53,382,44,4660,2274,38392,596,497
2020-09-26,6484,3794,65140,866,1,114,47,396,46,4660,1734,27511,438,510
2020-09-27,6484,3794,64954,866,1,110,25,405,48,4660,1731,27508,442,515
2020-09-28,6484,3794,65293,866,6,114,57,448,46,4660,2585,40587,744,562
2020-09-29,6484,3794,65722,866,3,120,58,464,46,4660,2362,39071,585,584
2020-09-30,6484,3794,65643,866,8,125,56,485,47,4660,2260,39286,542,610
2020-10-01,6484,3794,65342,866,8,129,56,479,50,4660,2372,41061,620,608
2020-10-02,6484,3794,65451,866,9,141,66,496,55,4660,2223,38433,581,637
2020-10-03,6484,3794,65419,866,7,147,44,508,57,4660,1697,27746,465,655
2020-10-04,6484,3794,65419,866,4,141,61,557,55,4660,1744,27730,447,698
2020-10-05,6484,3794,65754,866,12,146,58,589,61,4660,2554,40489,699,735
2020-10-06,6484,3794,65436,866,6,143,68,621,62,4660,2280,38411,586,764
2020-10-07,4988,2295,65704,866,13,151,71,670,66,3161,2286,38887,647,821
2020-10-08,4988,2295,65749,866,3,150,76,670,64,3161,2346,40937,631,820
2020-10-09,4988,2295,65391,866,4,160,90,664,70,3161,2085,35571,519,824
2020-10-10,4988,2295,63512,866,3,161,58,651,72,3161,1655,25745,478,812
2020-10-11,4988,2295,64386,866,7,170,68,693,71,3161,1649,26216,464,863
2020-10-12,4988,2295,64199,866,14,186,46,688,76,3161,1761,28415,482,874
2020-10-13,4988,2295,65556,866,3,191,77,740,88,3161,2344,37940,668,931
2020-10-14,4990,2300,65360,866,9,191,61,756,95,3166,2234,38520,596,947
2020-10-15,4990,2300,65582,866,7,198,63,781,98,3166,2320,40770,614,979
2020-10-16,4990,2298,65515,866,4,206,66,754,102,3164,2213,38027,611,960
2020-10-17,4990,2300,65505,866,4,209,71,771,101,3166,1731,27827,473,980
2020-10-18,5033,2337,65413,866,7,209,64,790,100,3203,1742,27925,472,999
2020-10-19,5033,2337,65541,866,12,218,80,808,108,3203,2518,40681,724,1026
2020-10-20,5033,2337,65525,866,4,210,88,828,116,3203,2258,38885,632,1038
2020-10-21,5033,2337,65459,866,5,225,63,809,122,3203,2272,38907,629,1034
2020-10-22,5033,2337,65493,866,2,228,77,828,120,3203,2310,40833,653,1056
2020-10-23,5033,2337,64465,922,6,228,73,841,124,3259,2193,37203,642,1069
2020-10-24,5033,2337,64914,922,6,233,101,870,124,3259,1722,27222,494,1103
2020-10-25,5033,2337,64896,922,3,232,49,889,121,3259,1714,27534,489,1121
2020-10-26,5033,2337,64930,922,8,229,71,922,123,3259,2530,40042,713,1151
2020-10-27,5033,2337,65257,922,4,228,86,952,124,3259,2278,38305,629,1180
2020-10-28,5033,2337,65454,922,2,223,72,943,119,3259,2265,38734,644,1166
2020-10-29,5033,2337,65446,922,3,227,79,969,117,3259,2381,41146,638,1196
2020-10-30,5033,2337,65362,922,8,228,75,968,122,3259,2217,37739,634,1196
2020-10-31,5033,2337,65366,922,3,224,55,990,114,3259,1725,27174,506,1214
2020-11-01,5033,2337,64996,922,5,227,59,1032,112,3259,1769,26997,543,1259
2020-11-02,5019,2323,65026,922,7,229,109,1094,121,3245,2358,39708,655,1323
2020-11-03,5019,2323,64689,922,6,235,93,1114,126,3245,2309,39455,688,1349
2020-11-04,5066,2376,65621,922,5,252,99,1102,131,3298,2301,40252,686,1354
2020-11-05,5066,2376,63977,922,3,242,104,1149,127,3298,2419,41058,656,1391
2020-11-06,5077,2387,65500,922,6,254,97,1131,132,3309,2180,37530,591,1385
2020-11-07,5077,2387,64989,922,5,259,103,1136,130,3309,2112,35340,521,1395
2020-11-08,5091,2401,65477,922,11,271,108,1218,137,3323,1728,27478,507,1489
2020-11-09,5093,2956,65534,1227,15,279,110,1249,135,4183,2389,42256,835,1528
2020-11-10,5172,2960,65986,1227,21,300,172,1323,148,4187,1956,31611,696,1623
2020-11-11,5172,2960,66610,1227,7,320,131,1353,156,4187,2146,36629,688,1673
2020-11-12,5172,2960,66579,1227,11,333,145,1415,172,4187,2344,42458,765,1748
2020-11-13,5176,2974,66332,1227,8,342,157,1429,177,4201,2239,39599,748,1771
2020-11-14,5176,2974,66577,1227,9,363,140,1439,178,4201,2136,37164,547,1802
2020-11-15,5176,2974,66601,1227,14,377,115,1458,180,4201,1759,29065,512,1835
2020-11-16,5188,2986,66405,1227,19,402,175,1532,200,4213,2313,41802,668,1934
2020-11-17,5188,2986,66719,1227,9,403,161,1577,210,4213,2282,40517,790,1980
2020-11-18,5188,2986,66719,1227,9,423,157,1570,217,4213,2264,40146,764,1993
2020-11-19,5188,2987,66531,1227,13,419,169,1540,229,4214,2306,42063,771,1959
2020-11-20,5193,2987,62097,1227,11,420,189,1584,224,4214,2190,36208,691,2004
2020-11-21,5152,2988,62115,1227,13,422,170,1646,225,4215,2096,33921,498,2068
2020-11-22,5194,2988,61694,1227,17,443,172,1661,231,4215,1689,28338,501,2104
2020-11-23,5197,2991,61372,1227,14,450,177,1761,236,4218,2264,38268,692,2211
2020-11-24,5173,3005,58909,1213,9,451,188,1804,239,4218,2195,34441,741,2255
2020-11-25,5175,3009,59311,1213,16,442,195,1845,248,4222,2234,34525,734,2287
2020-11-26,5177,3009,59104,1214,25,455,203,1994,241,4223,2316,36192,779,2449
2020-11-27,5182,3013,59353,1215,26,465,196,2035,232,4228,2155,33730,757,2500
2020-11-28,5183,3014,59215,1215,13,470,161,2073,228,4229,2066,26768,526,2543
2020-11-29,5183,3014,59321,1215,17,487,150,2111,247,4229,1720,26553,567,2598
2020-11-30,5190,3014,59973,1214,16,519,191,2197,254,4228,2252,36130,772,2716
2020-12-01,5189,3013,59507,1214,28,525,192,2253,260,4227,2173,34442,769,2778
2020-12-02,5189,3013,59178,1214,31,544,241,2286,263,4227,2119,33889,757,2830
2020-12-03,5189,3013,59487,1214,20,556,184,2348,262,4227,2189,36161,750,2904
2020-12-04,5242,3047,59631,1225,14,556,218,2409,259,4272,2002,31656,590,2965
2020-12-05,5242,3047,59577,1225,21,562,194,2465,254,4272,1686,26332,539,3027
2020-12-06,5242,3047,59612,1225,20,573,162,2558,267,4272,1671,26318,511,3131
2020-12-07,5242,3047,59517,1225,16,589,191,2605,283,4272,2197,35342,770,3194
2020-12-08,5242,3047,59804,945,16,602,205,2577,266,3992,2151,33898,787,3179
2020-12-09,5242,3047,59532,945,13,606,192,2525,280,3992,2163,33718,775,3131
2020-12-10,5242,3047,59451,945,39,646,242,2582,274,3992,2270,35695,782,3228
2020-12-11,5241,3042,59638,944,20,650,194,2557,300,3986,2143,33065,656,3207
2020-12-12,5241,3042,59226,944,16,659,201,2577,298,3986,2012,30856,528,3236
2020-12-13,5241,3042,59706,944,13,651,191,2692,311,3986,1681,26114,533,3343
2020-12-14,5241,3042,59468,944,20,659,283,2826,322,3986,2236,34946,787,3485
2020-12-15,5241,3042,59613,944,19,681,216,2767,333,3986,2150,33682,740,3448
2020-12-16,5241,3042,59143,944,27,697,275,2771,360,3986,2126,32977,740,3468
2020-12-17,5241,3042,59707,944,16,696,236,2778,354,3986,2221,35126,782,3474
2020-12-18,5241,3053,59781,937,20,703,227,2754,338,3990,2057,30642,656,3457
2020-12-19,5241,3053,59515,937,20,706,203,2799,342,3990,1984,30133,508,3505
2020-12-20,5241,3053,59687,937,15,701,236,2936,341,3990,1639,25149,511,3637
2020-12-21,5241,3053,59731,937,12,701,238,2956,356,3990,2150,33644,719,3657
2020-12-22,5241,3053,59824,937,23,702,249,2924,370,3990,2047,31551,738,3626
2020-12-23,5241,3053,59751,937,16,699,255,2888,364,3990,1978,30443,723,3587
2020-12-24,5241,3056,58864,937,7,694,157,2711,337,3993,1821,27000,608,3405
2020-12-25,5241,3056,59396,937,9,700,138,2844,363,3993,1787,26893,486,3544
2020-12-26,5241,3056,60014,937,28,712,329,3083,370,3993,1826,27838,506,3795
2020-12-27,5241,3056,60095,937,18,735,237,3153,384,3993,1525,23870,519,3888
2020-12-28,5241,3056,59302,937,10,744,190,3281,380,3993,1994,30896,566,4025
2020-12-29,5241,3056,59685,937,35,776,412,3492,378,3993,1987,31349,689,4268
2020-12-30,5241,3056,59388,937,14,793,259,3488,375,3993,2008,31459,689,4281
2020-12-31,5241,3053,59108,936,8,787,190,3431,385,3989,1921,30804,685,4218
2021-01-01,5241,3053,59468,936,11,778,189,3398,386,3989,1833,29432,485,4176
2021-01-02,5241,3053,59513,936,35,793,348,3595,392,3989,1850,29520,489,4388
2021-01-03,5241,3053,59449,936,21,804,293,3712,373,3989,1543,24725,449,4516
2021-01-04,5241,3053,59839,936,24,839,343,3754,430,3989,2071,35557,740,4593
2021-01-05,5241,3053,59945,936,31,852,352,3817,447,3989,2045,34245,728,4669
2021-01-06,5241,3053,60020,936,20,848,292,3813,440,3989,2124,33980,713,4661
2021-01-07,5241,3053,60014,936,23,848,322,3830,449,3989,2157,36153,722,4678
2021-01-08,5241,3047,60008,937,17,860,269,3777,450,3984,1934,31649,652,4637
2021-01-09,5241,3047,59919,937,16,856,303,3832,468,3984,1557,26040,517,4688
2021-01-10,5241,3047,59927,937,20,865,268,3996,471,3984,1588,26109,502,4861
2021-01-11,5241,3047,59981,937,29,881,306,4049,470,3984,2111,35692,732,4930
2021-01-12,5242,3047,59823,937,21,888,321,4032,494,3984,2093,33677,729,4920
2021-01-13,5242,3047,59989,948,37,903,322,4025,500,3995,2069,33602,715,4928
2021-01-14,5242,3047,59910,948,21,894,309,3977,491,3995,2078,33937,700,4871
2021-01-15,5242,3055,59901,951,17,889,309,3889,487,4006,2012,31204,540,4778
2021-01-16,5242,3056,59778,951,16,881,220,3838,492,4007,1938,25638,503,4719
2021-01-17,5242,3056,59940,951,16,878,246,3901,504,4007,1607,26013,528,4779
2021-01-18,5256,3058,59998,951,15,873,260,3874,496,4009,2113,35608,730,4747
2021-01-19,5256,3058,59871,951,20,876,312,3757,498,4009,2023,33728,729,4633
2021-01-20,5256,3058,59990,951,24,860,298,3704,497,4009,2040,33754,701,4564
2021-01-21,5256,3058,59533,951,14,849,254,3623,498,4009,2127,35482,722,4472
2021-01-22,5256,3059,59910,954,24,876,261,3527,505,4013,1952,31454,558,4403
2021-01-23,5257,3059,59766,954,21,873,174,3399,499,4013,1919,26071,521,4272
2021-01-24,5257,3059,59869,954,21,873,194,3413,479,4013,1567,26033,482,4286
2021-01-25,5251,3053,59960,954,19,850,230,3354,497,4007,2089,35486,675,4204
2021-01-26,5250,3053,59738,954,23,855,212,3225,486,4007,2065,33762,696,4080
2021-01-27,5250,3053,59685,954,14,833,234,3166,480,4007,2033,33626,716,3999
2021-01-28,5250,3053,59701,954,17,843,212,3088,479,4007,2034,32842,715,3931
2021-01-29,5256,3064,59709,952,14,812,205,2925,426,4016,1929,31477,522,3737
2021-01-30,5242,3064,59825,952,10,806,164,2896,469,4016,1575,31248,500,3702
2021-01-31,5242,3064,59765,952,9,799,151,2883,466,4016,1551,26169,491,3682
2021-02-01,5246,3065,59420,952,9,771,169,2735,458,4017,2040,33967,641,3506
2021-02-02,5246,3065,59947,952,12,759,266,2805,451,4017,2105,34263,722,3564
2021-02-03,5483,3249,59373,952,14,736,176,2696,430,4201,2111,33553,737,3432
2021-02-04,5483,3249,59511,952,5,727,175,2589,415,4201,2230,36041,720,3316
2021-02-05,5514,3246,59593,955,11,709,176,2473,413,4201,2142,33555,628,3182
2021-02-06,5483,3246,59576,955,12,717,133,2403,414,4201,1660,26124,524,3120
2021-02-07,5510,3275,59762,955,13,712,168,2445,407,4230,1678,26139,487,3157
2021-02-08,5501,3260,59739,955,9,678,133,2370,392,4215,2213,35825,724,3048
2021-02-09,5501,3260,59966,955,13,668,144,2301,388,4215,2135,34297,721,2969
2021-02-10,5501,3260,59894,955,13,644,132,2170,372,4215,2154,34241,722,2814
2021-02-11,5501,3260,59887,955,10,623,138,2084,357,4215,2183,34464,661,2707
2021-02-12,5501,3259,59595,959,6,614,129,2007,359,4218,2072,31655,701,2621
2021-02-13,5501,3259,59658,959,7,601,114,2004,353,4218,1687,31332,573,2605
2021-02-14,5501,3259,59667,959,13,606,123,1997,348,4218,1656,26079,573,2603
2021-02-15,5501,3259,59318,959,9,598,100,1922,349,4218,1803,33569,555,2520
2021-02-16,5501,3259,59819,959,17,606,112,1959,354,4218,2143,34260,744,2565
2021-02-17,5501,3259,59732,959,17,576,149,1891,330,4218,2162,34531,761,2467
2021-02-18,5501,3259,59920,959,10,562,153,1883,320,4218,2272,36694,784,2445
2021-02-19,5501,3260,59919,968,12,543,136,1831,312,4228,2165,34016,751,2374
2021-02-20,5365,3149,59809,968,10,563,125,1786,315,4117,2046,32087,506,2349
2021-02-21,5365,3149,59868,968,11,566,134,1846,317,4117,1666,26610,521,2412
2021-02-22,5365,3149,59953,968,12,567,122,1794,323,4117,2253,36791,734,2361
2021-02-23,5365,3149,59964,1056,14,587,143,1769,318,4205,2231,35039,753,2356
2021-02-24,5365,3149,59938,1056,17,573,135,1715,320,4205,2171,35051,733,2288
2021-02-25,5365,3149,60021,1056,15,570,134,1690,318,4205,2305,37171,799,2260
2021-02-26,5364,3148,59976,1055,10,554,145,1637,306,4203,2107,32510,705,2191
2021-02-27,5364,3148,59358,1055,13,569,113,1634,303,4203,2091,31703,541,2203
2021-02-28,5364,3148,59924,1055,12,564,114,1645,293,4203,1701,26950,543,2209
2021-03-01,5364,3148,60034,1055,14,577,131,1608,308,4203,2197,35101,681,2185
2021-03-02,5364,3148,60056,1055,15,560,150,1592,310,4203,2210,35087,759,2152
2021-03-03,5364,3148,59952,1080,11,558,131,1593,306,4228,2182,34983,777,2151
2021-03-04,5364,3148,60056,1080,13,547,134,1566,305,4228,2290,37059,786,2113
2021-03-05,5364,3148,59956,1078,11,542,135,1556,306,4226,2199,34201,771,2098
2021-03-06,5373,3157,59898,1078,10,534,116,1563,303,4235,2040,32113,548,2097
2021-03-07,5373,3157,59920,1078,10,544,111,1596,306,4235,1660,26820,529,2140
2021-03-08,5373,3157,59991,1078,16,554,133,1521,301,4235,2265,36878,709,2075
2021-03-09,5373,3157,60009,1078,11,551,150,1589,302,4235,2200,35003,740,2140
2021-03-10,5373,3157,59945,1078,12,546,141,1556,307,4235,2224,35089,775,2102
2021-03-11,5373,3157,59935,1078,6,546,141,1571,323,4235,2305,37052,770,2117
2021-03-12,5373,3157,59903,1078,9,537,158,1556,312,4235,2156,34223,731,2093
2021-03-13,5403,3193,59694,1079,8,540,294,1594,320,4272,2039,31885,511,2134
2021-03-14,5403,3193,59580,1079,7,562,147,1651,319,4272,1692,26526,504,2213
2021-03-15,5403,3193,59935,1079,7,555,136,1629,320,4272,2114,35073,701,2184
2021-03-16,5408,3198,59844,1079,26,590,168,1602,315,4277,2143,34722,773,2192
2021-03-17,5408,3198,59869,1079,10,584,163,1637,315,4277,2163,34610,749,2221
2021-03-18,5408,3198,59763,1079,18,588,172,1643,297,4277,2268,36595,790,2231
2021-03-19,5404,3198,59534,1080,15,580,199,1681,319,4278,2139,33540,774,2261
2021-03-20,5404,3198,59796,1080,12,584,123,1716,318,4278,2014,31471,552,2300
2021-03-21,5404,3198,59752,1080,14,591,138,1722,322,4278,1686,26323,525,2313
2021-03-22,5404,3198,59862,1080,9,622,220,1790,337,4278,2229,36601,725,2412
2021-03-23,5404,3198,59931,1080,14,638,191,1777,361,4278,2125,34718,721,2415
2021-03-24,5404,3198,59824,1080,14,639,179,1779,354,4278,2152,34688,702,2418
2021-03-25,5419,3198,59906,1080,8,665,197,1832,362,4278,2287,36833,719,2497
2021-03-26,5419,3198,59636,1083,14,675,151,1807,341,4281,1981,31943,511,2482
2021-03-27,5419,3198,59751,1083,13,675,133,1839,365,4281,1972,31749,496,2514
2021-03-28,5419,3198,59734,1083,12,693,158,1891,382,4281,1614,26638,505,2584
2021-03-29,5419,3198,59873,1083,19,705,177,1946,397,4281,2165,36617,698,2651
2021-03-30,5419,3198,59807,1083,9,712,195,1943,399,4281,2090,34556,702,2655
2021-03-31,5419,3198,59661,1083,16,717,222,1974,390,4281,2067,34380,619,2691
2021-04-01,5419,3198,59555,1083,17,722,228,1984,401,4281,2001,31746,640,2706
2021-04-02,5419,3207,59579,1092,13,754,220,2047,393,4299,1918,31062,513,2801
2021-04-03,5425,3207,59518,1092,16,791,222,2088,399,4299,1891,30885,456,2879
2021-04-04,5425,3207,59528,1092,17,819,192,2142,431,4299,1549,25852,498,2961
2021-04-05,5425,3207,59917,1092,35,859,243,2230,463,4299,2003,35724,560,3089
2021-04-06,5429,3211,60011,1092,15,856,270,2286,476,4303,1992,34060,651,3142
2021-04-07,5430,3212,60002,1092,26,897,284,2308,495,4304,1969,34417,684,3205
2021-04-08,5430,3212,60042,1092,20,919,284,2350,522,4304,2081,36826,675,3269
2021-04-09,5430,3219,59773,1088,17,960,307,2413,561,4307,1871,31801,638,3373
2021-04-10,5411,3200,59216,1088,30,996,309,2539,551,4288,1845,31150,507,3535
2021-04-11,5411,3200,59923,1088,24,1014,350,2654,589,4288,1494,26258,487,3668
2021-04-12,5411,3200,60028,1107,28,1028,342,2750,599,4307,2026,35809,701,3778
2021-04-13,5411,3200,60091,1107,23,1045,330,2838,627,4307,1918,33751,709,3883
2021-04-14,5411,3200,59797,1107,34,1070,327,2852,634,4307,1883,33585,693,3922
2021-04-15,5416,3200,60012,1107,35,1125,366,2913,674,4307,1943,35737,698,4038
2021-04-16,5416,3197,59968,1107,18,1154,411,3042,689,4304,1772,30850,637,4196
2021-04-17,5409,3190,59816,1107,24,1186,345,3103,700,4297,1719,30655,479,4289
2021-04-18,5417,3198,59963,1107,21,1216,333,3190,719,4305,1690,30762,478,4406
2021-04-19,5417,3198,59992,1107,16,1215,371,3205,747,4305,1866,34618,682,4420
2021-04-20,5417,3198,60027,1106,34,1261,414,3257,781,4304,1810,32925,694,4518
2021-04-21,5419,3198,59144,1106,30,1293,369,3207,803,4304,1779,32382,660,4500
2021-04-22,5422,3198,59755,1106,17,1308,321,3177,795,4304,1826,34473,675,4485
2021-04-23,5423,3219,59579,1102,20,1334,337,3124,797,4321,1669,29875,586,4458
2021-04-24,5460,3237,59588,1102,17,1342,330,3180,798,4339,1675,29968,442,4522
2021-04-25,5460,3237,59583,1102,27,1367,297,3195,801,4339,1618,30252,446,4562
2021-04-26,5460,3237,59912,1102,19,1365,331,3181,788,4339,1807,34528,663,4546
2021-04-27,5460,3237,59904,1102,20,1363,335,3153,795,4339,1759,32489,670,4516
2021-04-28,5409,3237,60166,1102,18,1380,343,3047,811,4339,1739,32330,658,4427
2021-04-29,5399,3237,60017,1102,21,1381,331,3001,821,4339,1822,34510,664,4382
2021-04-30,5398,3281,60067,1106,16,1386,336,2949,816,4387,1646,29985,574,4335
2021-05-01,5614,3493,59837,1106,22,1387,312,3000,803,4599,1606,30024,452,4387
2021-05-02,5614,3493,59849,1106,18,1381,291,3058,789,4599,1624,30298,444,4439
2021-05-03,5614,3493,59947,1106,22,1384,305,2946,799,4599,1845,34429,570,4330
2021-05-04,5614,3493,59955,1106,17,1375,317,2851,816,4599,1793,32462,708,4226
2021-05-05,5618,3498,59984,1106,16,1346,283,2819,812,4604,1754,32397,683,4165
2021-05-06,5619,3499,59951,1106,25,1320,270,2725,815,4605,1867,34560,722,4045
2021-05-07,5619,3508,59462,1110,23,1310,296,2648,791,4618,1695,29611,601,3958
2021-05-08,5619,3508,59365,1110,12,1300,266,2639,776,4618,1395,24496,467,3939
2021-05-09,5619,3508,59407,1110,13,1287,236,2709,746,4618,1417,24987,455,3996
2021-05-10,5627,3516,59906,1110,22,1281,234,2594,753,4626,1908,34484,715,3875
2021-05-11,5627,3516,59734,1110,23,1259,258,2632,744,4626,1815,32614,715,3891
2021-05-12,5627,3516,59853,1110,12,1262,218,2564,765,4626,1806,30743,695,3826
2021-05-13,5627,3516,59858,1110,21,1268,251,2543,772,4626,1896,32684,712,3811
2021-05-14,5624,3520,59783,1110,13,1269,178,2350,759,4630,1705,28349,603,3619
2021-05-15,5624,3520,59427,1110,12,1278,190,2361,756,4630,1367,22901,475,3639
2021-05-16,5624,3520,59803,1110,9,1268,179,2430,731,4630,1400,23390,469,3698
2021-05-17,5624,3520,59749,1110,10,1247,167,2314,751,4630,1934,33210,756,3561
2021-05-18,5624,3520,59826,1110,11,1195,220,2278,705,4630,1905,32987,782,3473
2021-05-19,5626,3522,59732,1110,17,1163,215,2230,656,4632,1963,32996,753,3393
2021-05-20,5626,3522,59788,1110,7,1140,209,2137,673,4632,2075,34990,801,3277
2021-05-21,5629,3529,59772,1112,23,1116,202,2144,658,4641,1882,30154,686,3260
2021-05-22,5629,3529,59719,1112,14,1088,169,2035,627,4641,1852,30046,504,3123
2021-05-23,5629,3529,59685,1112,6,1079,197,2076,612,4641,1847,30280,522,3155
2021-05-24,5629,3529,59356,1112,15,1073,177,2017,619,4641,1956,32483,569,3090
2021-05-25,5629,3529,59818,1112,27,1060,198,1944,599,4641,1984,33351,794,3004
2021-05-26,5629,3528,59786,1108,21,1028,172,1892,594,4636,2015,33556,788,2920
2021-05-27,5629,3528,59315,1108,15,1000,155,1782,585,4636,2101,35686,821,2782
2021-05-28,5631,3528,59641,1108,20,960,151,1677,557,4636,1917,30767,719,2637
2021-05-29,5631,3528,60305,1108,7,940,108,1641,533,4636,1486,23829,500,2581
2021-05-30,5631,3528,59274,1108,19,939,121,1588,511,4636,1915,25479,546,2527
2021-05-31,5631,3528,59450,1108,13,896,120,1502,509,4636,2134,35528,790,2398
2021-06-01,5631,3528,59431,1108,13,869,118,1482,518,4636,2070,33474,766,2351
2021-06-02,5631,3528,59383,1108,10,810,116,1414,476,4636,2062,33258,791,2224
2021-06-03,5636,3533,59549,1108,8,771,122,1328,473,4641,2071,33302,788,2099
2021-06-04,5636,3528,59433,1107,6,743,112,1293,464,4635,1990,30670,711,2036
2021-06-05,5636,3528,60872,1107,11,728,116,1297,450,4635,1574,30453,514,2025
2021-06-06,5636,3528,60502,1107,9,710,120,1278,442,4635,1648,33386,539,1988
2021-06-07,5636,3528,59921,1045,13,688,111,1243,403,4573,2062,33617,600,1931
2021-06-08,5636,3528,59819,1045,10,674,95,1177,413,4573,2100,33971,763,1851
2021-06-09,5636,3528,59889,1045,15,656,114,1129,400,4573,2090,34016,748,1785
2021-06-10,5632,3526,59746,1034,7,640,99,1048,394,4560,2177,36067,637,1688
2021-06-11,5631,3529,59590,1035,14,608,102,1006,373,4564,1999,31141,664,1614
2021-06-12,5632,3530,59053,1035,5,609,99,995,368,4565,1941,30492,620,1604
2021-06-13,5632,3530,59027,1035,6,593,84,975,357,4565,1913,30883,629,1568
2021-06-14,5632,3530,59165,1035,9,563,71,981,337,4565,2174,35555,751,1544
2021-06-15,5632,3530,59136,1035,6,542,91,930,327,4565,2109,33803,759,1472
2021-06-16,5632,3530,58779,1035,5,514,67,874,319,4565,2104,33568,701,1388
2021-06-17,5632,3530,58652,1035,11,508,87,816,313,4565,2119,33429,701,1324
2021-06-18,5632,3525,58744,1035,12,491,79,780,315,4560,2069,32712,674,1271
2021-06-19,5632,3525,59156,1035,10,488,81,749,297,4560,1576,30689,419,1237
2021-06-20,5632,3525,59746,1035,5,478,72,777,287,4560,1595,31121,434,1255
2021-06-21,5632,3525,59049,1035,12,471,55,696,282,4560,2102,33758,712,1167
2021-06-22,5632,3525,59297,1035,5,460,62,673,274,4560,2212,36218,720,1133
2021-06-23,5632,3525,59079,1035,4,449,65,638,274,4560,2127,33983,703,1087
2021-06-24,5632,3525,59125,1035,8,420,54,646,274,4560,2133,33927,710,1066
2021-06-25,5632,3525,58708,1035,7,414,66,607,253,4560,2127,33012,510,1021
2021-06-26,5632,3525,58850,1035,2,410,70,594,258,4560,1973,25393,472,1004
2021-06-27,5632,3525,58528,1035,3,396,53,605,246,4560,1973,25485,498,1001
2021-06-28,5632,3525,59080,1035,3,377,60,603,241,4560,2136,33564,730,980
2021-06-29,5632,3525,58922,1035,7,374,56,562,237,4560,2320,36390,771,936
2021-06-30,5632,3525,58420,1035,6,360,74,538,227,4560,2206,33612,771,898
2021-07-01,5632,3525,58571,1035,4,349,68,503,209,4560,1677,25572,517,852
2021-07-02,5632,3525,58601,1035,5,333,45,497,213,4560,1646,25323,515,830
2021-07-03,5630,3523,58657,1035,3,314,43,498,203,4558,1660,25650,495,812
2021-07-04,5630,3523,58364,1035,2,309,41,501,198,4558,1699,25427,481,810
2021-07-05,5630,3523,58669,1039,4,302,54,498,198,4562,2255,34221,771,800
2021-07-06,5630,3523,59053,1039,3,288,52,502,192,4562,2371,36938,792,790
2021-07-07,5634,3525,59112,1050,0,279,58,501,184,4575,2253,34773,766,780
2021-07-08,5634,3525,58982,1050,6,275,46,448,180,4575,2255,34596,749,723
2021-07-09,5634,3529,58305,1059,2,272,54,429,174,4588,2100,31417,665,701
2021-07-10,5634,3529,58188,1059,3,275,54,439,172,4588,2044,31151,494,714
2021-07-11,5634,3529,58943,1059,3,279,30,422,160,4588,2101,31935,506,701
2021-07-12,5634,3529,59112,1059,5,259,40,421,165,4588,2190,34461,696,680
2021-07-13,5634,3529,59663,1059,5,249,56,413,158,4588,2263,35444,728,662
2021-07-14,5634,3529,59706,1059,1,237,54,408,152,4588,2365,37546,749,645
2021-07-15,5634,3529,59647,1059,4,224,43,402,151,4588,2231,35122,733,626
2021-07-16,5634,3528,59469,1065,4,211,37,384,146,4593,2102,32304,652,595
2021-07-17,5634,3528,58661,1065,4,209,49,393,135,4593,1717,31861,507,602
2021-07-18,5634,3528,58769,1065,3,210,38,397,130,4593,1693,31968,501,607
2021-07-19,5634,3528,59232,1065,2,205,48,381,133,4593,2220,34556,740,586
2021-07-20,5634,3528,59652,1065,8,213,38,357,110,4593,2230,35139,705,570
2021-07-21,5634,3528,59662,1065,2,214,48,351,121,4593,2331,37286,743,565
2021-07-22,5634,3528,59410,1065,1,209,42,336,118,4593,2194,34771,614,545
2021-07-23,5634,3523,59079,1062,3,196,41,315,116,4585,2106,31935,686,511
2021-07-24,5634,3523,59269,1062,2,188,39,321,116,4585,2090,32005,508,509
2021-07-25,5634,3523,59499,1062,6,191,42,337,111,4585,2058,32294,521,528
2021-07-26,5462,3366,59737,1062,4,189,41,325,118,4428,2244,34812,752,514
2021-07-27,5462,3366,59738,1062,7,185,45,309,117,4428,2272,35179,775,494
2021-07-28,5462,3370,60046,1069,3,188,50,311,118,4439,2373,37285,754,499
2021-07-29,5462,3370,59679,1069,3,183,46,313,119,4439,2209,34920,748,496
2021-07-30,5462,3370,59518,1069,2,171,45,316,123,4439,2087,31992,657,487
2021-07-31,5462,3370,59593,1069,1,160,43,315,114,4439,2057,31472,524,475
2021-08-01,5462,3370,59609,1069,0,162,36,320,110,4439,2066,31692,517,482
2021-08-02,5462,3370,59460,1069,5,168,30,319,109,4439,2110,32218,517,487
2021-08-03,5462,3370,59237,1069,1,170,30,327,106,4439,2139,32549,587,497
2021-08-04,5463,3371,59400,1069,8,176,69,341,103,4440,2363,37181,788,517
2021-08-05,5463,3371,59326,1069,4,173,67,372,101,4440,2229,34738,778,545
2021-08-06,5463,3371,58497,1069,5,177,62,339,103,4440,2098,31616,723,516
2021-08-07,5463,3371,59486,1069,1,175,64,354,97,4440,1725,26272,534,529
2021-08-08,5463,3371,59234,1069,4,172,49,342,94,4440,1727,26274,531,514
2021-08-09,5463,3366,58950,1070,6,179,51,369,95,4436,2223,34661,769,548
2021-08-10,5463,3366,59898,1070,10,187,65,380,102,4436,2235,35415,786,567
2021-08-11,5463,3366,59384,1070,14,207,91,386,104,4436,2346,37369,829,593
2021-08-12,5463,3366,59614,1070,4,204,74,415,99,4436,2194,35417,810,619
2021-08-13,5463,3365,59538,1067,10,214,71,426,99,4432,2093,32308,730,640
2021-08-14,5463,3365,59587,1067,6,222,73,409,103,4432,1734,26471,570,631
2021-08-15,5463,3365,59774,1067,7,227,59,426,104,4432,1725,26945,551,653
2021-08-16,5463,3365,59282,1067,8,243,72,468,118,4432,2237,35167,810,711
2021-08-17,5463,3365,59473,1067,4,248,78,486,119,4432,2232,35283,831,734
2021-08-18,5463,3365,59779,1067,15,255,84,523,114,4432,2298,37614,808,778
2021-08-19,5460,3365,59809,1067,11,269,76,561,122,4432,2192,35433,782,830
2021-08-20,5460,3373,59339,1066,7,272,76,606,126,4439,2065,32397,728,878
2021-08-21,4732,2682,52607,709,3,225,76,556,99,3391,1695,26676,531,781
2021-08-22,4732,2682,52689,709,4,240,61,601,102,3391,1677,26789,543,841
2021-08-23,4732,2682,52234,709,4,245,66,612,112,3391,1803,29245,638,857
2021-08-24,5460,3373,59517,1066,10,333,106,712,154,4439,2212,35569,783,1045
2021-08-25,5460,3373,59505,1066,21,350,88,740,166,4439,2270,37629,808,1090
2021-08-26,5454,3373,59488,1066,13,365,112,797,157,4439,2193,35146,780,1162
2021-08-27,5454,3368,59193,1045,13,381,95,810,160,4413,2074,32262,715,1191
2021-08-28,5454,3368,58615,1045,8,380,95,819,173,4413,2045,26189,536,1199
2021-08-29,5454,3368,59158,1045,6,394,78,831,170,4413,2046,26972,530,1225
2021-08-30,5454,3368,59514,1045,18,411,120,877,177,4413,2146,34913,694,1288
2021-08-31,5454,3368,59311,1066,22,434,140,905,194,4434,2209,35233,816,1339
2021-09-01,5454,3368,59468,1066,15,449,140,927,213,4434,2258,37534,836,1376
2021-09-02,5454,3368,58921,1066,21,468,127,935,221,4434,2173,34968,781,1403
2021-09-03,5454,3371,59319,1064,19,482,111,1006,222,4435,2009,32384,627,1488
2021-09-04,5454,3371,59197,1064,11,496,123,1040,228,4435,2013,26347,570,1536
2021-09-05,5454,3371,58885,1064,19,516,114,1057,238,4435,1991,26331,554,1573
2021-09-06,5454,3371,59512,1064,15,535,131,1077,241,4435,2017,27235,582,1612
2021-09-07,5454,3371,59065,1064,21,556,119,1151,242,4435,2229,34959,803,1707
2021-09-08,5454,3371,59207,1064,29,569,170,1224,258,4435,2326,37433,923,1793
2021-09-09,5458,3371,59273,1064,13,579,126,1241,263,4435,2202,35513,785,1820
2021-09-10,5458,3372,59389,1065,15,600,122,1312,272,4437,2106,33194,694,1912
2021-09-11,3076,1739,39838,1065,11,451,75,1114,169,2804,535,15464,52,1565
2021-09-12,5458,3372,59492,1065,13,631,122,1351,269,4437,2038,33213,538,1982
2021-09-13,5458,3372,59645,1065,27,657,122,1336,278,4437,2197,35634,715,1993
2021-09-14,5458,3372,59701,1065,21,677,152,1426,292,4437,2292,38313,764,2103
2021-09-15,5458,3372,59615,1065,17,678,112,1441,297,4437,2299,38194,887,2119
2021-09-16,5459,3372,59620,1065,23,684,120,1440,315,4437,2301,37882,818,2124
2021-09-17,5461,3375,59563,1067,17,672,119,1470,298,4442,2178,35258,834,2142
2021-09-18,4733,2682,52644,709,9,523,78,1339,219,3391,1723,27295,549,1862
2021-09-19,4733,2682,52692,709,10,537,63,1364,216,3391,1761,27524,533,1901
2021-09-20,5461,3375,59661,1067,25,708,147,1551,330,4442,2231,37803,886,2259
2021-09-21,5435,3351,59696,1067,19,728,150,1632,330,4418,2233,38040,882,2360
2021-09-22,5435,3351,59239,1067,18,732,143,1658,340,4418,2228,37970,904,2390
2021-09-23,5435,3351,59591,1067,24,743,177,1692,332,4418,2229,37788,667,2435
2021-09-24,5435,3353,59613,1069,13,740,115,1678,329,4422,2056,33085,763,2418
2021-09-25,4707,2658,52383,709,8,594,62,1456,230,3367,1703,27126,535,2050
2021-09-26,4707,2658,52866,709,9,611,58,1490,235,3367,1705,27535,543,2101
2021-09-27,5435,3353,59670,1069,19,751,146,1726,337,4422,2278,37537,861,2477
2021-09-28,5435,3353,59651,1069,19,758,176,1747,328,4422,2292,37860,886,2505
2021-09-29,5435,3353,59582,1069,19,763,150,1722,323,4422,2293,37879,918,2485
2021-09-30,4707,2658,52326,709,15,610,101,1528,235,3367,1969,31655,712,2138
2021-10-01,5435,3352,58266,1069,9,744,111,1714,318,4421,2176,33817,811,2458
2021-10-02,4707,2658,52715,709,9,605,68,1542,231,3367,1836,28916,580,2147
2021-10-03,4707,2658,52361,709,6,603,67,1544,232,3367,1845,28692,574,2147
2021-10-04,5435,3352,59171,1069,21,744,127,1782,323,4421,2296,36721,904,2526
2021-10-05,5435,3352,59602,1069,16,743,214,1806,319,4421,2352,38133,846,2549
2021-10-06,5435,3352,59644,1069,16,726,157,1851,317,4421,2350,38186,937,2577
2021-10-07,5435,3352,59566,1069,14,729,167,1864,312,4421,2323,37768,951,2593
2021-10-08,5435,3345,59358,1069,10,728,136,1827,309,4414,2248,35589,866,2555
2021-10-09,5435,3345,58825,1069,15,716,112,1775,314,4414,1861,28651,598,2491
2021-10-10,5435,3345,58855,1069,6,714,96,1794,310,4414,1835,28564,580,2508
2021-10-11,5435,3345,59579,1069,12,694,123,1805,308,4414,1851,29227,577,2499
2021-10-12,5435,3344,59479,1069,19,718,111,1778,326,4413,2299,37196,978,2496
2021-10-13,5435,3345,59760,1069,9,710,146,1797,331,4414,2365,38692,971,2507
2021-10-14,5435,3345,60167,1069,20,713,135,1754,342,4414,2350,38753,880,2467
2021-10-15,5396,3324,59854,1072,9,705,130,1769,340,4396,2263,36632,787,2474
2021-10-16,5396,3324,60090,1072,10,697,99,1726,331,4396,2217,35743,611,2423
2021-10-17,5396,3324,60057,1072,15,706,109,1740,336,4396,2233,35211,583,2446
2021-10-18,5396,3324,60016,1072,24,703,149,1722,345,4396,2334,37867,837,2425
2021-10-19,5383,3314,60259,1072,9,676,108,1732,348,4386,2393,38530,867,2408
2021-10-20,5383,3314,60017,1072,16,674,116,1668,335,4386,2358,38692,856,2342
2021-10-21,5383,3314,59205,1072,15,639,110,1678,307,4386,2275,35283,845,2317
2021-10-22,5383,3314,59262,1069,17,630,113,1626,310,4383,2129,33731,766,2256
2021-10-23,5383,3314,59238,1069,9,634,117,1580,309,4383,2103,32922,574,2214
2021-10-24,5383,3314,58874,1069,10,626,104,1570,308,4383,2109,32335,572,2196
2021-10-25,5383,3314,59411,1069,14,616,93,1529,294,4383,2321,37042,854,2145
2021-10-26,5383,3314,59871,1069,25,615,121,1491,296,4383,2376,38246,870,2106
2021-10-27,5383,3314,59831,1069,24,613,134,1489,301,4383,2361,38289,863,2102
2021-10-28,5383,3314,60126,1069,19,606,118,1479,291,4383,2371,38539,734,2085
2021-10-29,5383,3315,59677,1069,15,604,105,1448,292,4384,2197,34953,747,2052
2021-10-30,5383,3315,59743,1069,14,590,97,1421,294,4384,2150,28283,546,2011
2021-10-31,5383,3315,59239,1069,13,580,113,1444,283,4384,2120,27937,524,2024
2021-11-01,5383,3315,59788,1071,19,578,91,1436,270,4386,2241,36057,830,2014
2021-11-02,5383,3315,59816,1071,13,563,113,1498,266,4386,2286,37039,831,2061
2021-11-03,5383,3315,58843,1071,18,543,124,1413,274,4386,2275,36210,813,1956
2021-11-04,5383,3315,59758,1071,14,525,140,1411,270,4386,2281,37437,846,1936
2021-11-05,5383,3313,59536,1075,9,516,111,1411,259,4388,2177,34837,739,1927
2021-11-06,5383,3313,59763,1075,7,504,98,1412,252,4388,2179,34216,528,1916
2021-11-07,5383,3313,59452,1075,11,499,102,1425,249,4388,2133,34037,545,1924
2021-11-08,5383,3313,58111,1073,11,496,105,1379,252,4386,2303,35806,769,1875
2021-11-09,5383,3313,59047,1073,14,501,99,1379,259,4386,2332,36734,830,1880
2021-11-10,5383,3313,59787,1073,13,485,115,1295,255,4386,2316,37255,828,1780
2021-11-11,5383,3313,59090,1073,9,469,108,1327,254,4386,2233,34236,561,1796
2021-11-12,5383,3311,58539,1076,15,472,112,1315,247,4387,2206,33562,731,1787
2021-11-13,5383,3311,59480,1076,13,471,124,1316,243,4387,2165,33610,526,1787
2021-11-14,5383,3311,58826,1076,10,476,85,1326,251,4387,2184,32854,527,1802
2021-11-15,5383,3311,59249,1076,13,473,94,1293,239,4387,2271,36120,815,1766
2021-11-16,5383,3311,59799,1076,8,451,119,1322,239,4387,2311,36794,819,1773
2021-11-17,5383,3311,59580,1076,12,447,104,1303,238,4387,2313,36810,788,1750
2021-11-18,5383,3311,59885,1076,12,445,120,1290,241,4387,2292,36820,810,1735
2021-11-19,5382,3304,58839,1072,11,446,111,1265,245,4376,2207,34260,716,1711
2021-11-20,5381,3304,59060,1072,8,445,109,1245,246,4376,2178,34275,555,1690
2021-11-21,5381,3304,59120,1072,16,458,93,1258,243,4376,2162,33419,518,1716
2021-11-22,5381,3304,58794,1072,7,449,118,1250,237,4376,2293,36197,802,1699
2021-11-23,5381,3304,59446,1072,13,460,108,1227,235,4376,2349,37781,817,1687
2021-11-24,5381,3304,58132,1072,12,452,101,1210,223,4376,2340,36691,827,1662
2021-11-25,5381,3304,59267,1072,10,451,101,1133,230,4376,2340,37693,847,1584
2021-11-26,5381,3306,59258,1073,13,446,105,1138,231,4379,2233,35113,762,1584
2021-11-27,5381,3306,58530,1073,15,435,106,1161,230,4379,2092,31943,570,1596
2021-11-28,5381,3306,58562,1073,7,444,88,1151,232,4379,2101,30802,587,1595
2021-11-29,5381,3306,58914,1073,19,470,101,1164,238,4379,2262,36120,827,1634
2021-11-30,5381,3306,58951,1073,4,458,80,1186,229,4379,2408,35456,820,1644
2021-12-01,5381,3306,58888,1073,10,443,112,1182,227,4379,2380,35464,811,1625
2021-12-02,5381,3306,58828,1073,11,435,94,1144,229,4379,2367,37193,796,1579
2021-12-03,5344,3304,58736,1071,16,454,118,1089,232,4375,2305,34938,714,1543
2021-12-04,5344,3304,57818,1071,7,446,100,1093,231,4375,2214,31320,551,1539
2021-12-05,5344,3304,57943,1071,4,457,63,1129,234,4375,2146,29513,514,1586
2021-12-06,5344,3304,59012,1071,13,446,119,1117,229,4375,2400,36951,804,1563
2021-12-07,5344,3304,59677,1071,16,426,101,1123,230,4375,2454,38160,825,1549
2021-12-08,5344,3304,59149,1071,12,430,111,1098,226,4375,2486,37826,851,1528
2021-12-09,5344,3304,59666,1071,17,425,108,1096,220,4375,2489,38190,897,1521
2021-12-10,5344,3307,59512,1069,15,420,114,1092,217,4376,2352,35584,763,1512
2021-12-11,5344,3307,59327,1069,11,424,114,1110,213,4376,2258,32520,533,1534
2021-12-12,5344,3307,59174,1069,15,439,101,1125,208,4376,2250,32139,504,1564
2021-12-13,5344,3307,58518,1069,18,453,100,1086,229,4376,2410,36390,812,1539
2021-12-14,5344,3307,58648,1069,11,453,135,1066,234,4376,2439,37257,848,1519
2021-12-15,5352,3315,58368,1069,11,440,123,1097,238,4384,2452,36931,883,1537
2021-12-16,5352,3315,59080,1069,16,424,139,1126,223,4384,2453,37402,841,1550
2021-12-17,5356,3316,58866,1070,16,435,157,1142,225,4386,2357,34850,748,1577
2021-12-18,5356,3316,58128,1070,22,453,135,1136,238,4386,2223,31047,558,1589
2021-12-19,5356,3316,58381,1070,15,459,137,1199,241,4386,2193,30781,548,1658
2021-12-20,5356,3316,59001,966,12,468,148,1203,241,4282,2329,35039,799,1671
2021-12-21,5358,3318,58705,966,14,463,183,1248,249,4284,2359,34884,821,1711
2021-12-22,5358,3318,58593,966,14,455,209,1340,240,4284,2332,33661,774,1795
2021-12-23,5359,3318,58688,966,17,461,221,1338,246,4284,2242,33669,793,1799
2021-12-24,5359,3318,58538,966,10,451,147,1386,233,4284,2138,31902,787,1837
2021-12-25,5359,3318,58328,966,10,449,126,1435,230,4284,2028,28401,552,1884
2021-12-26,5359,3318,58389,966,34,476,386,1692,231,4284,2087,30867,550,2168
2021-12-27,5359,3318,58417,966,21,490,310,1922,240,4284,2143,31694,591,2412
2021-12-28,5359,3318,59146,966,20,476,371,2156,242,4284,2152,33004,553,2632
2021-12-29,5359,3318,59101,966,34,510,516,2489,247,4284,2202,33375,784,2999
2021-12-30,5360,3319,58304,965,32,533,527,2829,253,4284,2244,33044,780,3362
2021-12-31,5359,3318,57923,966,28,550,488,2789,272,4284,2229,32368,767,3339
2022-01-01,5359,3318,58233,966,25,574,444,3291,272,4284,2159,30142,553,3865
2022-01-02,5359,3318,57884,966,44,619,590,3655,298,4284,2225,32002,565,4274
2022-01-03,5359,3318,58173,966,29,645,700,4113,308,4284,2207,32587,552,4758
2022-01-04,5359,3314,59240,965,38,704,667,4618,336,4279,2272,34272,795,5322
2022-01-05,5360,3315,58714,965,48,739,806,5041,365,4280,2156,33914,816,5780
2022-01-06,5360,3315,58730,965,49,791,886,5340,370,4280,2330,35495,846,6131
2022-01-07,5359,3313,58482,961,36,865,921,5878,402,4274,2270,35321,821,6743
2022-01-08,5359,3313,58947,961,37,903,806,6277,403,4274,2116,32967,551,7180
2022-01-09,5359,3313,58840,961,21,914,819,6537,408,4274,2084,32738,529,7451
2022-01-10,5359,3313,59050,961,46,973,921,7115,428,4274,2174,35205,814,8088
2022-01-11,5359,3313,58851,961,40,1021,1041,7530,441,4274,2193,35040,826,8551
2022-01-12,5359,3313,59249,961,46,1029,1019,7950,463,4274,2213,35151,813,8979
2022-01-13,5359,3313,58826,961,44,1067,1038,8275,477,4274,2187,34394,821,9342
2022-01-14,5359,3314,58692,960,38,1096,999,8525,520,4274,2035,32070,752,9621
2022-01-15,5359,3314,59173,960,49,1121,1014,8865,544,4274,1998,32034,535,9986
2022-01-16,5359,3314,59172,960,39,1124,829,9135,560,4274,1961,31764,531,10259
2022-01-17,5359,3314,58636,960,44,1180,835,9408,577,4274,2066,33430,795,10588
2022-01-18,5359,3314,59191,960,54,1200,909,9387,590,4274,2110,34691,747,10587
2022-01-19,5359,3314,59302,960,56,1216,972,9527,589,4274,2111,34457,761,10743
2022-01-20,5359,3314,59233,960,38,1198,928,9523,606,4274,2105,34531,726,10721
2022-01-21,5368,3320,59372,965,47,1214,876,9437,630,4285,2007,32626,698,10651
2022-01-22,5368,3320,59049,965,31,1208,778,9465,624,4285,1999,31640,523,10673
2022-01-23,5368,3320,59220,965,41,1206,726,9630,620,4285,1952,31717,500,10836
2022-01-24,5368,3320,59389,965,45,1233,772,9789,638,4285,2097,34367,750,11022
2022-01-25,5368,3320,59307,965,41,1192,800,9542,643,4285,2125,34869,756,10734
2022-01-26,5373,3320,59126,965,25,1159,728,9395,618,4285,2135,34717,753,10554
2022-01-27,5373,3320,59066,965,39,1169,793,9279,640,4285,2137,34533,776,10448
2022-01-28,5373,3320,59408,964,45,1166,758,8903,636,4284,1991,33127,712,10069
2022-01-29,5373,3320,58517,964,33,1141,586,8770,597,4284,1955,31503,542,9911
2022-01-30,5373,3320,58496,964,27,1139,530,8831,587,4284,1950,31483,486,9970
2022-01-31,5373,3320,59310,964,41,1144,638,8812,596,4284,2058,34499,756,9956
2022-02-01,5373,3320,59297,964,32,1099,659,8609,569,4284,2117,35271,749,9708
2022-02-02,5373,3320,58989,964,33,1073,608,8321,578,4284,2115,35425,778,9394
2022-02-03,5374,3321,58595,964,31,1057,639,8092,550,4285,2137,34891,777,9149
2022-02-04,5374,3318,58638,966,38,1037,549,7795,531,4284,2128,34808,959,8832
2022-02-05,5374,3318,59119,966,30,1003,498,7592,522,4284,2163,34613,621,8595
2022-02-06,5374,3318,58684,966,25,1003,434,7588,522,4284,2109,34157,584,8591
2022-02-07,5374,3318,58908,966,28,1008,455,7493,537,4284,2170,35160,987,8501
2022-02-08,5374,3318,58267,966,30,976,565,7310,521,4284,2152,35061,969,8286
2022-02-09,5374,3318,57982,966,26,956,542,7150,519,4284,2176,34992,789,8106
2022-02-10,5374,3318,59095,966,30,920,494,6880,490,4284,2208,35992,790,7800
2022-02-11,5374,3333,58613,967,30,874,434,6618,466,4300,2215,35625,811,7492
2022-02-12,5374,3333,57774,967,23,846,394,6401,440,4300,2197,34066,606,7247
2022-02-13,5374,3333,58359,967,18,839,313,6492,429,4300,2110,33344,586,7331
2022-02-14,5374,3333,59020,967,17,805,395,6348,423,4300,2199,36321,762,7153
2022-02-15,5374,3333,59158,967,20,780,381,6153,421,4300,2215,36866,766,6933
2022-02-16,5374,3333,59363,967,21,767,425,5992,410,4300,2254,36913,775,6759
2022-02-17,5374,3336,59031,971,26,760,393,5801,398,4307,2161,36538,749,6561
2022-02-18,5374,3336,58935,971,15,730,350,5621,388,4307,2167,36520,616,6351
2022-02-19,5374,3336,58984,971,24,694,353,5513,373,4307,2096,33229,586,6207
2022-02-20,5374,3336,59073,971,19,680,292,5555,373,4307,2084,33581,593,6235
2022-02-21,5374,3336,58977,971,18,671,281,5506,361,4307,2111,33432,564,6177
2022-02-22,5374,3336,58551,971,9,659,340,5382,346,4307,2187,36155,751,6041
2022-02-23,5374,3336,58533,971,16,651,376,5302,346,4307,2223,36299,754,5953
2022-02-24,5374,3336,58593,971,37,627,308,5006,325,4307,2237,36593,758,5633
2022-02-25,5374,3326,59161,971,14,593,313,4832,312,4297,2179,37202,749,5425
2022-02-26,5374,3326,58909,971,13,581,300,4685,321,4297,2098,33841,594,5266
2022-02-27,5374,3326,58774,971,12,566,211,4671,302,4297,2106,33533,560,5237
2022-02-28,5374,3326,59246,971,15,570,247,4568,291,4297,2215,37176,740,5138
2022-03-01,5374,3326,59328,971,13,558,312,4431,293,4297,2128,35968,771,4989
2022-03-02,5374,3326,59328,971,14,547,341,4414,291,4297,2143,36018,792,4961
2022-03-03,5374,3326,59050,971,11,540,297,4326,261,4297,2268,37368,782,4866
2022-03-04,5374,3328,58953,972,16,513,251,4209,249,4300,2258,36898,801,4722
2022-03-05,5374,3328,58190,972,14,506,242,4110,236,4300,2157,33473,758,4616
2022-03-06,5374,3328,58538,972,16,508,229,4146,239,4300,2139,33512,766,4654
2022-03-07,5374,3328,59165,972,10,505,246,4145,245,4300,2251,37018,825,4650
2022-03-08,5374,3328,58319,972,12,492,268,4028,234,4300,2310,36688,843,4520
2022-03-09,5374,3328,58319,972,8,489,265,4060,230,4300,2320,36763,851,4549
2022-03-10,5374,3328,59307,972,8,467,249,3902,224,4300,2308,37708,827,4369
2022-03-11,5374,3324,57538,973,8,448,231,3810,216,4297,2279,35825,857,4258
2022-03-12,5374,3324,58631,973,10,440,217,3713,207,4297,2230,33781,693,4153
2022-03-13,5374,3324,58722,973,2,432,187,3722,194,4297,2208,33962,663,4154
2022-03-14,5367,3317,58366,973,15,435,246,3742,202,4290,2306,36501,789,4177
2022-03-15,5367,3317,59114,973,10,409,257,3722,191,4290,2327,37514,840,4131
2022-03-16,5367,3317,59112,973,7,404,257,3639,182,4290,2322,37354,823,4043
2022-03-17,5367,3317,59104,973,7,374,249,3567,176,4290,2403,37904,777,3941
2022-03-18,5367,3318,58530,972,11,359,260,3539,162,4290,2370,36937,798,3898
2022-03-19,5367,3318,57185,972,10,355,229,3523,166,4290,2303,33009,617,3878
2022-03-20,5367,3318,57061,972,8,364,222,3583,162,4290,2207,32803,613,3947
2022-03-21,5371,3320,57670,983,14,362,262,3628,170,4303,2258,36082,780,3990
2022-03-22,5367,3318,59188,972,13,365,309,3637,173,4290,2303,38055,788,4002
2022-03-23,5367,3318,59188,972,11,365,344,3645,169,4290,2309,38090,791,4010
2022-03-24,5369,3318,58869,972,13,368,290,3694,168,4290,2259,35282,782,4062
2022-03-25,5369,3316,59045,974,15,357,341,3668,169,4290,2275,35790,754,4025
2022-03-26,5369,3316,58134,974,16,358,321,3790,164,4290,2229,33193,632,4148
2022-03-27,5369,3316,57736,974,10,362,280,3872,163,4290,2232,32633,614,4234
2022-03-28,5369,3316,59086,974,17,374,344,3874,155,4290,2251,34954,792,4248
2022-03-29,5369,3316,58870,974,14,364,346,3999,166,4290,2369,37133,809,4363
2022-03-30,5369,3316,58868,974,15,354,357,4022,166,4290,2379,37136,830,4376
2022-03-31,5362,3309,59120,974,22,341,450,4185,156,4283,2408,35426,823,4526
2022-04-01,5362,3309,58532,970,16,339,425,4253,155,4279,2404,34304,812,4592
2022-04-02,5362,3309,58829,970,24,347,415,4347,154,4279,2359,33860,657,4694
2022-04-03,5362,3309,58922,970,15,345,414,4596,159,4279,2248,33683,637,4941
2022-04-04,5362,3309,58171,970,17,365,443,4746,173,4279,2305,35588,811,5111
2022-04-05,5362,3309,58868,970,19,358,493,4888,171,4279,2384,36899,817,5246
2022-04-06,5362,3309,58868,970,16,360,486,4887,172,4279,2383,36914,818,5247
2022-04-07,5187,3134,59012,970,19,373,559,5153,172,4104,2317,34862,824,5526
2022-04-08,5187,3134,58407,970,17,379,545,5135,178,4104,2295,34438,818,5514
2022-04-09,5187,3134,58403,970,14,389,450,5297,179,4104,2258,32972,674,5686
2022-04-10,5187,3134,58507,970,10,390,424,5518,169,4104,2225,32960,668,5908
2022-04-11,5187,3134,58184,970,20,401,534,5619,173,4104,2283,35113,818,6020
2022-04-12,5187,3134,57878,970,34,416,563,5821,183,4104,2302,35253,842,6237
2022-04-13,5187,3134,57878,970,27,420,538,5821,184,4104,2314,35206,847,6241
2022-04-14,5187,3134,58184,970,19,418,650,6091,184,4104,2249,33455,814,6509
2022-04-15,5187,3134,58389,970,28,443,566,6120,193,4104,2233,32955,657,6563
2022-04-16,5187,3134,57507,970,18,451,508,6162,185,4104,2198,31984,643,6613
2022-04-17,5187,3134,58109,970,16,444,457,6356,191,4104,2184,32050,650,6800
2022-04-18,5187,3134,58200,970,25,458,523,6550,194,4104,2212,32441,672,7008
2022-04-19,5187,3146,58881,968,22,454,554,6591,193,4114,2317,35984,831,7045
2022-04-20,5187,3146,58881,968,25,450,562,6554,189,4114,2317,35922,832,7004
2022-04-21,5187,3146,58886,968,15,428,537,6669,175,4114,2425,34423,839,7097
2022-04-22,5187,3144,58905,969,20,432,613,6628,173,4113,2403,34304,826,7060
2022-04-23,5185,3142,58498,971,26,455,516,6621,183,4113,2386,32745,653,7076
2022-04-24,5185,3142,58656,971,9,452,409,6727,187,4113,2229,32589,642,7179
2022-04-25,5185,3142,58532,971,25,453,515,6828,188,4113,2299,35254,814,7281
2022-04-26,5183,3140,58464,971,19,443,555,6756,185,4111,2297,33884,767,7199
2022-04-27,5185,3142,58461,969,22,454,560,6763,190,4111,2293,33886,770,7217
2022-04-28,5360,3317,59044,969,27,442,532,6740,183,4286,2410,34733,839,7182
2022-04-29,5360,3322,58960,972,24,415,530,6618,172,4294,2246,34405,818,7033
2022-04-30,5360,3322,58184,972,17,403,466,6550,171,4294,2242,32550,678,6953
2022-05-01,5360,3322,58254,972,21,434,355,6614,175,4294,2220,32290,666,7048
2022-05-02,5360,3322,58563,972,11,420,398,6692,172,4294,2319,35195,841,7112
2022-05-03,5360,3322,59088,972,11,420,481,6639,178,4294,2355,36489,816,7059
2022-05-04,5360,3322,59083,972,15,421,512,6662,178,4294,2353,34681,719,7083
2022-05-05,5179,3322,58013,972,14,399,450,6446,166,4294,2452,35520,828,6845
2022-05-06,5180,3353,58491,985,18,388,444,6302,155,4338,2468,35615,850,6690
2022-05-07,5180,3353,57959,985,18,377,379,6119,151,4338,2432,34438,719,6496
2022-05-08,5180,3353,57993,985,13,367,325,6226,149,4338,2291,33896,727,6593
2022-05-09,5180,3353,58892,985,16,356,358,6223,145,4338,2324,35903,868,6579
2022-05-10,5180,3353,58086,985,13,340,426,6067,148,4338,2370,35800,888,6407
2022-05-11,5180,3353,58086,985,16,344,448,6077,145,4338,2369,35822,886,6421
2022-05-12,5180,3353,58730,985,19,334,362,5834,141,4338,2419,34297,854,6168
2022-05-13,5180,3359,58858,988,13,319,383,5578,126,4347,2401,34349,854,5897
2022-05-14,5180,3359,58433,988,14,316,339,5478,128,4347,2312,32906,718,5794
2022-05-15,5180,3359,58403,988,10,329,272,5538,133,4347,2225,32911,701,5867
2022-05-16,5180,3359,58903,988,11,331,354,5503,138,4347,2272,34158,828,5834
2022-05-17,5180,3359,57735,988,15,329,377,5423,141,4347,2326,33687,857,5752
2022-05-18,5180,3359,57735,988,17,327,364,5392,140,4347,2323,33753,862,5719
2022-05-19,5180,3359,58472,988,14,327,318,5121,148,4347,2369,36646,856,5448
2022-05-20,5180,3353,58882,988,12,319,293,4685,153,4341,2357,36893,869,5004
2022-05-21,5180,3353,58704,988,18,308,263,4770,152,4341,2341,35271,708,5078
2022-05-22,5180,3353,58601,988,14,300,214,4747,146,4341,2331,34486,739,5047
2022-05-23,5180,3353,57979,988,9,295,235,4769,138,4341,2326,34672,707,5064
2022-05-24,5180,3353,58304,988,10,300,256,4699,143,4341,2405,36100,867,4999
2022-05-25,5180,3353,58304,988,7,296,284,4677,143,4341,2435,36233,847,4973
2022-05-26,5175,3352,59114,988,8,273,256,4435,123,4340,2429,32868,854,4708
2022-05-27,5175,3352,58781,986,5,250,261,4269,118,4338,2371,32501,831,4519
2022-05-28,5175,3352,58524,986,11,246,231,4146,113,4338,2395,31549,712,4392
2022-05-29,5175,3352,58173,986,10,247,208,4205,111,4338,2401,30905,716,4452
2022-05-30,5175,3352,58631,986,12,245,236,4148,112,4338,2429,32148,824,4393
2022-05-31,5175,3352,58652,986,9,231,262,3934,106,4338,2488,32782,890,4165
2022-06-01,5175,3352,58652,986,7,228,251,3901,109,4338,2493,32880,892,4129
2022-06-02,5175,3352,59070,986,6,217,266,3778,98,4338,2454,37806,828,3995
2022-06-03,5175,3347,57886,991,11,201,223,3639,86,4338,2303,36171,796,3840
2022-06-04,5175,3347,57133,991,4,194,144,3561,86,4338,2373,34859,687,3755
2022-06-05,5175,3347,57332,991,5,199,121,3530,93,4338,2353,34643,700,3729
2022-06-06,5175,3347,58903,991,11,196,249,3521,97,4338,2371,36964,731,3717
2022-06-07,5175,3347,58733,991,6,187,264,3445,95,4338,2406,37374,843,3632
2022-06-08,5175,3347,58734,991,10,190,256,3428,92,4338,2412,37498,844,3618
2022-06-09,5175,3347,59330,991,13,177,223,3333,86,4338,2445,38126,843,3510
2022-06-10,5175,3345,58885,992,10,176,257,3281,87,4337,2348,37458,837,3457
2022-06-11,5175,3345,58695,992,8,170,139,3278,84,4337,2351,36751,660,3448
2022-06-12,5175,3345,58938,992,11,168,127,3283,89,4337,2362,36534,676,3451
2022-06-13,5175,3345,58857,992,12,180,265,3277,86,4337,2371,37182,782,3457
2022-06-14,5175,3345,58191,992,11,167,222,3144,84,4337,2420,37085,823,3311
2022-06-15,5175,3345,58191,992,9,170,230,3132,84,4337,2441,37195,820,3302
2022-06-16,5175,3345,58248,992,4,157,244,3102,74,4337,2147,31474,725,3259
2022-06-17,5175,3348,57034,990,9,158,213,3012,72,4338,2156,30245,720,3170
2022-06-18,5175,3348,58578,990,6,150,133,3011,69,4338,2127,30697,698,3161
2022-06-19,5175,3348,57381,990,2,159,131,3053,70,4338,2114,30233,678,3212
2022-06-20,5175,3348,58797,990,24,170,311,3102,78,4338,2174,31594,734,3272
2022-06-21,5175,3348,58512,990,14,168,264,3124,81,4338,2161,31770,723,3292
2022-06-22,5175,3348,58494,990,10,166,290,3116,82,4338,2579,37579,817,3282
2022-06-23,5175,3348,59042,990,10,167,273,3082,81,4338,2390,33000,863,3249
2022-06-24,5175,3341,58179,988,8,156,228,3033,73,4329,2324,31959,870,3189
2022-06-25,5175,3341,58697,988,5,154,148,3022,74,4329,2284,31121,698,3176
2022-06-26,5175,3341,58147,988,6,163,124,3028,69,4329,2280,30639,665,3191
2022-06-27,5175,3341,58706,988,20,167,416,3178,70,4329,2329,32009,784,3345
2022-06-28,5175,3341,59752,988,9,168,270,3234,80,4329,2351,32940,711,3402
2022-06-29,5175,3341,59752,988,10,168,306,3238,83,4329,2363,32966,840,3406
2022-06-30,5177,3352,58439,992,6,178,279,3121,89,4344,2320,37071,808,3299
2022-07-01,5178,3352,58253,992,5,166,270,3178,87,4344,2290,35423,674,3344
2022-07-02,5179,3352,58316,992,4,166,162,3203,85,4344,2253,35734,670,3369
2022-07-03,5180,3352,58206,992,2,170,151,3264,83,4344,2295,35590,675,3434
2022-07-04,5181,3352,58219,992,18,182,521,3457,75,4344,2346,36469,807,3639
2022-07-05,5182,3352,59134,992,12,188,398,3510,82,4344,2402,37862,818,3698
2022-07-06,5182,3352,59134,992,12,189,405,3527,83,4344,2406,37875,814,3716
2022-07-07,5183,3353,58302,991,10,201,386,3615,82,4344,2395,36671,826,3816
2022-07-08,5183,3351,54249,988,18,200,368,3723,83,4339,2377,32672,815,3923
2022-07-09,5183,3351,58354,988,13,211,207,3741,80,4339,2276,35737,678,3952
2022-07-10,5183,3351,58226,988,5,208,187,3786,79,4339,2307,35554,660,3994
2022-07-11,5183,3351,57458,988,12,214,601,3986,79,4339,2331,35338,817,4200
2022-07-12,5183,3351,58243,988,18,223,463,4119,80,4339,2669,38082,830,4342
2022-07-13,5183,3351,58242,988,16,218,407,4121,81,4339,2360,36807,823,4339
2022-07-14,5183,3351,58239,987,9,213,468,4391,95,4338,2351,36442,773,4604
2022-07-15,5183,3360,58626,987,15,202,455,4371,88,4347,2295,36810,785,4573
2022-07-16,5183,3360,58448,987,9,194,230,4407,89,4347,2278,35549,654,4601
2022-07-17,5183,3360,58061,987,7,204,241,4548,85,4347,2259,34649,647,4752
2022-07-18,5183,3360,58662,987,33,229,738,4696,84,4347,2312,35681,779,4925
2022-07-19,5183,3360,58281,987,14,240,540,4944,91,4347,2387,36179,773,5184
2022-07-20,5183,3360,58281,987,14,238,542,4937,89,4347,2391,36243,775,5175
2022-07-21,5217,3373,57398,987,17,236,471,4983,90,4360,2334,35561,784,5219
2022-07-22,5217,3373,58332,987,17,245,490,4834,95,4360,2287,36307,810,5079
2022-07-23,5217,3373,57542,987,7,249,222,4832,93,4360,2273,34677,634,5081
2022-07-24,5217,3373,57495,987,3,250,237,5023,90,4360,2278,34342,615,5273
2022-07-25,5217,3373,58258,987,28,258,739,5089,99,4360,2312,35860,767,5347
2022-07-26,5217,3373,58031,987,20,276,525,5239,114,4360,2348,36093,777,5515
2022-07-27,5217,3373,58039,987,16,273,511,5223,114,4360,2356,36090,783,5496
2022-07-28,5217,3373,58515,987,17,283,430,5189,115,4360,2325,36175,780,5472
2022-07-29,5217,3373,58512,987,17,285,422,5028,114,4360,2274,35979,804,5313
2022-07-30,5217,3373,57694,987,13,285,209,4997,107,4360,2246,34320,656,5282
2022-07-31,5217,3373,57619,987,8,301,190,4969,108,4360,2190,34085,647,5270
2022-08-01,5217,3373,58312,987,30,291,537,5097,105,4360,2243,35029,669,5388
2022-08-02,5217,3373,58401,987,13,299,471,5165,108,4360,2314,35848,779,5464
2022-08-03,5217,3373,58401,987,15,300,490,5215,111,4360,2315,35862,776,5515
2022-08-04,5217,3373,58647,987,11,275,420,4991,115,4360,2291,36713,811,5266
2022-08-05,5217,3379,57471,988,10,264,379,4952,114,4367,2266,35263,767,5216
2022-08-06,5217,3379,58144,988,3,264,232,4882,112,4367,2245,35252,656,5146
2022-08-07,5217,3379,58274,988,2,266,180,4945,116,4367,2217,35247,653,5211
2022-08-08,5218,3380,58970,987,24,274,529,4896,107,4367,2281,36604,739,5170
2022-08-09,5218,3380,58577,987,13,262,421,5067,112,4367,2342,36739,802,5329
2022-08-10,5218,3380,58587,987,11,262,425,5074,113,4367,2343,36788,809,5336
2022-08-11,5218,3380,58908,987,21,262,329,4933,116,4367,2339,37070,877,5195
2022-08-12,5218,3358,58465,986,22,267,371,4837,125,4344,2330,36410,819,5104
2022-08-13,5218,3358,57580,986,11,260,195,4871,129,4344,2286,34976,686,5131
2022-08-14,5218,3358,57663,986,11,257,192,4928,126,4344,2265,34842,674,5185
2022-08-15,5218,3358,58209,986,24,248,462,4938,119,4344,2328,36088,815,5186
2022-08-16,5218,3358,57976,986,16,245,392,5030,115,4344,2389,36333,838,5275
2022-08-17,5218,3358,57950,986,15,248,398,5020,115,4344,2391,36343,823,5268
2022-08-18,5218,3358,58641,986,16,246,398,5008,117,4344,2350,36803,836,5254
2022-08-19,5218,3359,57831,985,21,245,409,4952,115,4344,2315,36123,854,5197
2022-08-20,5218,3359,57909,985,10,248,231,4935,119,4344,2271,35261,688,5183
2022-08-21,5218,3359,57844,985,7,253,184,5003,116,4344,2259,35009,686,5256
2022-08-22,5218,3359,58535,985,25,255,474,4965,107,4344,2290,36565,816,5220
2022-08-23,5217,3358,58795,986,13,262,398,5072,108,4344,2290,37012,820,5334
2022-08-24,5217,3358,58795,986,12,263,396,5077,108,4344,2292,36995,820,5340
2022-08-25,5217,3358,58461,986,20,249,386,4971,111,4344,2310,36701,802,5220
2022-08-26,5217,3363,58246,984,17,249,418,4905,107,4347,2331,36159,791,5154
2022-08-27,5217,3363,57322,984,12,261,285,4844,105,4347,2284,34580,672,5105
2022-08-28,5217,3363,57676,984,9,260,245,4910,100,4347,2287,34659,698,5170
2022-08-29,5217,3363,58020,984,25,272,535,4861,105,4347,2295,35886,805,5133
2022-08-30,5217,3363,58339,984,15,248,442,4823,108,4347,2346,36806,835,5071
2022-08-31,5217,3363,58339,984,14,244,424,4825,108,4347,2370,36873,830,5069
2022-09-01,5217,3363,57624,984,11,223,287,4692,98,4347,2348,36048,823,4915
2022-09-02,5217,3363,58119,991,12,212,285,4552,99,4354,2314,36316,796,4764
2022-09-03,5217,3363,57993,991,13,211,270,4552,94,4354,2263,35417,668,4763
2022-09-04,5217,3363,57895,991,11,207,270,4610,96,4354,2265,35161,689,4817
2022-09-05,5217,3363,57785,991,15,220,266,4501,95,4354,2304,35493,668,4721
2022-09-06,5217,3363,57821,991,13,218,364,4616,94,4354,2364,35839,809,4834
2022-09-07,5217,3363,57821,991,13,219,397,4618,95,4354,2383,35961,809,4837
2022-09-08,5401,3363,58723,991,16,214,285,4542,89,4354,2401,37415,834,4756
2022-09-09,5401,3363,58873,991,15,210,281,4439,84,4354,2373,37541,714,4649
2022-09-10,5401,3363,58172,991,14,212,165,4392,88,4354,2341,36099,693,4604
2022-09-11,5401,3363,58011,991,11,211,155,4421,91,4354,2336,35506,689,4632
2022-09-12,5401,3358,58780,986,26,213,392,4479,92,4344,2382,37102,809,4692
2022-09-13,5401,3358,59111,986,19,225,349,4460,96,4344,2394,38154,833,4685
2022-09-14,5401,3358,59111,986,21,224,343,4467,96,4344,2390,38151,830,4691
2022-09-15,5401,3358,59046,986,18,228,300,4416,93,4344,2401,38093,804,4644
2022-09-16,5401,3355,58505,983,20,226,277,4329,98,4338,2381,37326,807,4555
2022-09-17,5401,3355,56581,983,13,220,165,4280,96,4338,2324,34814,681,4500
2022-09-18,5401,3355,56965,983,12,226,151,4315,99,4338,2364,34912,654,4541
2022-09-19,5401,3355,58848,983,24,228,384,4406,97,4338,2399,37455,718,4634
2022-09-20,5401,3355,59155,983,21,229,276,4445,96,4338,2418,38191,818,4674
2022-09-21,5401,3355,59154,983,20,229,276,4444,96,4338,2417,38215,815,4673
2022-09-22,5401,3355,58991,983,21,216,445,4475,89,4338,2413,38084,830,4691
2022-09-23,5401,3357,57909,986,8,210,360,4502,78,4343,2403,36705,845,4712
2022-09-24,5401,3357,58060,986,14,216,295,4501,89,4343,2360,35933,684,4717
2022-09-25,5401,3357,58050,986,9,216,280,4509,95,4343,2369,35737,701,4725
2022-09-26,5393,3349,58135,986,20,227,479,4587,104,4335,2431,36652,832,4814
2022-09-27,5393,3349,58975,986,13,232,397,4813,95,4335,2434,38115,845,5045
2022-09-28,5393,3349,58975,986,12,230,363,4800,91,4335,2448,38205,841,5030
2022-09-29,5399,3349,58541,986,18,250,370,4933,100,4335,2414,37522,798,5183
2022-09-30,5399,3346,59010,985,7,247,377,4881,98,4331,2385,37895,726,5128
2022-10-01,5399,3346,58633,985,5,241,184,4839,100,4331,2378,36531,690,5080
2022-10-02,5399,3346,57936,985,3,235,181,4878,86,4331,2406,35794,693,5113
2022-10-03,5399,3346,58044,985,18,237,589,5087,93,4331,2447,36195,829,5324
2022-10-04,5399,3346,58742,985,11,236,377,5181,89,4331,2525,37694,908,5417
2022-10-05,5399,3346,58742,985,10,243,385,5179,91,4331,2521,37574,905,5422
2022-10-06,5399,3346,57968,985,8,238,382,5308,91,4331,2461,36897,911,5546
2022-10-07,5399,3348,58658,981,12,240,393,4864,101,4329,2418,37790,914,5104
2022-10-08,5399,3348,58523,981,4,238,203,5229,100,4329,2390,36211,737,5467
2022-10-09,5399,3348,58625,981,5,230,184,5266,106,4329,2344,35989,740,5496
2022-10-10,5399,3348,58512,981,14,249,473,5401,104,4329,2406,35430,721,5650
2022-10-11,5399,3348,58438,981,19,261,523,5694,104,4329,2482,36624,880,5955
2022-10-12,5399,3348,58438,981,19,262,539,5721,107,4329,2487,36654,875,5983
2022-10-13,5399,3348,58486,981,14,272,440,5818,103,4329,2503,37183,857,6090
2022-10-14,5399,3350,58925,979,11,269,475,5743,108,4329,2433,37643,853,6012
2022-10-15,5399,3350,58598,979,4,271,215,5719,110,4329,2369,36488,707,5990
2022-10-16,5399,3350,57948,979,3,287,222,5892,107,4329,2382,35708,708,6179
2022-10-17,5399,3350,58004,979,19,291,596,5943,113,4329,2382,36424,821,6234
2022-10-18,5399,3350,58881,979,6,286,448,5848,119,4329,2441,38040,827,6134
2022-10-19,5399,3350,58881,979,12,285,471,5867,121,4329,2456,38014,839,6152
2022-10-20,5399,3350,58360,980,9,280,430,6121,121,4330,2473,36819,860,6401
2022-10-21,5399,3344,58556,983,9,273,376,6149,112,4327,2458,35989,806,6422
2022-10-22,5399,3344,58195,983,14,284,403,6046,114,4327,2420,35496,710,6330
2022-10-23,5399,3344,58828,983,10,268,354,6141,114,4327,2424,35964,716,6409
2022-10-24,5399,3344,58847,983,31,277,546,6146,118,4327,2436,36966,855,6423
2022-10-25,5399,3344,58786,983,14,275,379,6114,110,4327,2487,37374,864,6389
2022-10-26,5399,3344,58786,983,14,275,379,6114,110,4327,2487,37374,864,6389
2022-10-27,5399,3344,58865,983,13,249,465,6126,112,4327,2497,37701,887,6375
2022-10-28,5399,3344,58142,981,12,253,407,6041,108,4325,2481,36395,870,6294
2022-10-29,5399,3344,58252,981,6,249,217,6049,107,4325,2477,35602,758,6298
2022-10-30,5399,3344,58732,981,4,245,197,5993,107,4325,2450,36050,731,6238
2022-10-31,5399,3344,57754,981,21,248,481,5986,102,4325,2478,35852,854,6234
2022-11-01,5399,3344,58509,981,10,251,431,6018,106,4325,2493,37094,874,6269
2022-11-02,5399,3344,58509,981,7,249,447,6010,104,4325,2507,37234,864,6259
2022-11-03,5399,3344,59294,981,23,269,482,6006,102,4325,2507,37596,892,6275
2022-11-04,5399,3340,58812,975,19,265,450,5841,98,4315,2500,37103,875,6106
2022-11-05,5399,3340,57753,975,13,270,308,5809,110,4315,2498,35743,771,6079
2022-11-06,5399,3340,58802,975,11,262,252,5837,110,4315,2450,34343,725,6099
2022-11-07,5399,3340,57753,975,26,253,551,5830,107,4315,2443,35900,833,6083